111111
1000C1
10CE01
1000P1
111111
10C001
111111
