11111111
1E1C1011
11100C01
11100001
1C000P01
11111111
