111111111111111111111111111111111
1000C00000C0000C0000C000000C00001
10100100111100100P00100C000111001
101001001000001000001000001000101
10111100111000100000100C001000101
10100100100000100E001000001000101
101001001111001111001111000111001
100C000000C000000C00000C0000C0001
111111111111111111111111111111111
