1111111111
10C000C001
1000C00001
100E0000C1
1111111111
