1111111111
10P0000C01
10C00C0001
10E0C00001
1111111111
