1111111111
1000010C01
10P00C0001
1C01001101
10E0C001C1
1111111111
