1111111111
10C0000C01
10P00C0001
1C00000001
10E0C000C1
1111111111
