1111111111
10C000C000
1000C0P001
100E0000C1
1111111111
